NO textures/wall_with_N.xpm
WE textures/wall_with_W.xpm
EA textures/wall_with_E.xpm
SO textures/wall_with_S.xpm

F 37,61,42
C 87,82,82

1111111111111111111111111
1000000001000000000000001
1011100001110000111001111
1000100000000000000000101
1111111110101111101011101
10000000001000000N0100001
1110111110111101111011111
1010000000000000000010001
1001111111111111111100111
1110000000000000000000001
1001001001010010011001001
1111111111111111111111111